1111111111111111111
1C010000000C0D00001
10000111100000P0001
100011E00C000000011
1111111111111111111
